{
  "Id": 1,
  "Name": "Room torch doorway",
  "CaseSize": 53,
  "nbCaseHeight": 12,
  "nbCaseWidth": 11,
  "Matrice": [
    [0, 1, 1, 1, 1, 1, 1, 1, 1, 1, 1],
    [0, 1, 1, 1, 1, 1, 1, 1, 1, 1, 1],
    [0, 1, 1, 1, 1, 1, 1, 1, 1, 1, 1],
    [0, 1, 1, 1, 1, 1, 1, 1, 1, 1, 1],
    [0, 1, 1, 1, 1, 1, 1, 1, 1, 1, 1],
    [1, 1, 1, 1, 1, 1, 1, 1, 1, 1, 1],
    [0, 0, 0, 1, 1, 1, 1, 1, 1, 1, 1],
    [0, 0, 0, 0, 0, 0, 1, 1, 1, 1, 1],
    [0, 1, 0, 0, 0, 0, 0, 1, 1, 1, 1],
    [0, 1, 1, 0, 0, 0, 0, 1, 1, 1, 1],
    [0, 1, 1, 1, 1, 1, 1, 1, 1, 1, 1],
    [0, 1, 1, 1, 1, 1, 1, 1, 1, 1, 1]
  ]
}